
SO ./path_to_the_south_texture
WE ./path_to_the_west_texture
EA ./path_to_the_east_texture
NO ./path_to_the_north_texture

F 192,192,192
C 135,206,235


11111111
10000001
10000001
100N0001
11111111
