

F   192, 192 , 192

SO     ./textures/SO.xpm
WE      ./textures/WE.xpm


C   135, 206 ,250

NO      ./textures/NO.xpm
EA     ./textures/EA.xpm

    11111111111111111   11111
    10000000000000001   10001
    10000000000000001   10001
    1000000000000000111110001
    1000000111110000000000001
    10000001   10000000000001
    1000000111110000000000001
    1000000000000000000000001
    1000000000000000000000001
    1000000000000000000000001 11111
    10000000000000000011111011000001
    1000000000000000001   100000001
    11111110000000000011111011000001
          100000000000S000001 11111
    1111111000000000000000001
    1000000000000000000000001
    1001111100000000000000001
    1001   100000000000000001
    1001111100000000000000001
    1000000000000000000000001
    1000000000000000000000001
    11111000000000001111000011111
        1000000000001  1000000001
    11111000111000001111000011111
    100000001 100000000000001
    100000001 100000000000001
    111111111 111111111111111