
F 255,0,0
C 0,255,0

SO ./path_to_the_south_texture
WE ./path_to_the_west_texture
EA ./path_to_the_east_texture
NO ./path_to_the_north_texture


1111111111
1010110001
1000000001
10100010E1
1111111111