
F 192,192,192
C 135,206,235

SO ./path_to_the_south_texture
WE ./path_to_the_west_texture
EA ./path_to_the_east_texture
NO ./path_to_the_north_texture

11111111111111111
10000000000000001
10000000000000001
10000000000000001
100S0000000000001
10000000000000001
10000000000000001
11111111111111111
