

SO ./path_to_the_south_texture
WE ./path_
NO ./path_to_the_north_texture
EA ./path_to_the_east_texture

F 192,192,192
C 135,206,255

111111111111111111111111111111111111111111111111111111111111111111111111111111111111111111111111111111111111111111111111111111111111111111111111111111111111111111111111111111111111111111
100000000000000000000000000000000000000000000000000000000000000000000000000000000000000000000000000000000000000000000000000000000000000000000000000000000000000000000000000000000000000001
100000000000000000000000000000000000000000000000000000000000000000000000000000000000000000000000000000000000000000000000000000000000000000000000000000000000000000000000000000000000000001
100000000000000000000000000000000000000000000000000000000000000000000000000000000000000000000000000000000000000000000000000000000000000000000000000000000000000000000000000000000000000001
100000000000000000000000000000000000000000000000000000000000000000000000000000000000000000000000000000000000000000000000000000000000000000000000000000000000000000000000000000000000000001
100000000000000000000000000000000000011111111111111111111111111111111111111000000000000000000000000000000000000000000000000000000000000000000000011111100000000000000000000000000000000001
10000000000000000000000000000000000001                                    1000000000000000000000000000000000000000000000000000000000000000000000011111100000000000000000000000000000000001
10000000000000000000000000000000000001                                    1000000000000000000000000000000000000000000000000000000000000000000000011111100000000000000000000000000000000001
10000000000000000000000000000000000001                                    1000000000000000000000000000000000000000000000000000000000000000000000011111100000000000000000000000000000000001
10000000000000000000000000000000000001                                    1000000000000000000000000000000000000000000000000000000000000000000000011111100000000000000000000000000000000001
10000000000000000000000000000000000001                                    1000000000000000000000000000000000000000000000000000000000000000000000011111100000000000000000000000000000000001
10000000000000000000000000000000000001                                    1000000000000000000000000000000000000000000000000000000000000000000000011111100000000000000000000000000000000001
10000000000000000000000000000000000001                                    1000000000000000000000000000000000000000000000000000000000000000000000011111100000000000000000000000000000000001
10000000000000000000000000000000000001                                    1000000000000000000000000000000000000000000000000000000000000000000000011111100000000000000000000000000000000001
100000000000000000000000000000000000011111111111111111111111111111111111111000000000000000000000000000000000000000000000000000000000000000000000011111100000000000000000000000000000000001
100000000000000000000000000000000000000000000000000000000000000000000000000000000000000000000000000000000000000000000000000000000000000000000000011111100000000000000000000000000000000001
100000000000000000000000000000000000000000000000000000000000000000000000000000000000000000000000000000000000000000000000000000000000000000000000000000000000000000000000000000000000000001
100000000000000000000000000000000000000000000000000000000000000000000000000000000000000000000000000000000000000000000000000000000000000000000000000000000000000000000000000000000000000001
100000000000000000000000000000000000000000000000000000000000000000000000000000000000000000000000000000000000000000000000000000000000000000000000000000000000000000000000000000000000000001
100000000000000000000000000000000000000000000000000000000000000000000000000000000000000000000000000000000000000000000000000000000000000000000000000000000000000000000000000000000000000001
100000000000000000000000000000000000000000000000000000001100000000000000000000000000000000000000000000000000000000000000000000000000000000000000000000000000000000000000000000000000000001
100000000000000000000000000000000000000000000000000000001100000000000000000000000000000000000000000000000000000000000000000000000000000000000000000000000000000000000000000000000000000001
100000000000000000000000000000000000000000000000000000001100000000000000000000000000000000000000000000000000000000000000000000000000000000000000000000000000000000000000000000000000000001
100000000000000000000000000000000000000000000000000000001100000000000000000000000000000000000000000000000000000000000000000000000000000000000000000000000000000000000000000000000000000001
100000000000000000000000000000000000000000000000000000001100000000000000000000000000000000000000000000000000000000000000000000000000000000000000000000000000000000000000000000000000000001
100000000000000000000000000000000000000000000000000000001100000000000000000000000000000000000000000000000000000000000000000000000000000000000000000000000000000000000000000000000000000001
100000000000000000000000000000000000000000000000000000001100000000000000000000000000000000000000000000000000000000000000000000000000000000000000000000000000000000000000000000000000000001
100000000000000000000000000000000000000000000000000000001100000000000000000000000000000000000000000000000000000000000000000000000000000000000000000000000000000000000000000000000000000001
100000000000000000000000000000000000000000000000000000001100000000000000000000000000000000000000000000000000000000001111111111111111111111111111111111111111100000000000000000000000000001
100000000000000000000000000000000000000000000000000000001100000000000000000000000000000000000000000000000000000000001                                       100000000000000000000000000001
100000000000000000000000000000000000000000000000000000001100000000000000000000000000000000000000000000000000000000001                                       100000000000000000000000000001
100000000000000000000000000000000000000000000000000000001100000000000000000000000000000000000000000000000000000000001                                       100000000000000000000000000001
100000000000000000000000000000000000000000000000000000001100000000000000000000000000000000000000000000000000000000001                                       100000000000000000000000000001
100000000000000000000000000000000000000000000000000000001100000000000000000000000000000000000000000000000000000000001                                       100000000000000000000000000001
100000000000000000000000000000000000000000000000000000001100000000000000000000000000000000000000000000000000000000001                                       100000000000000000000000000001
100000000000000000000000000000000000000000000000000000000000000000000000000000000000000000000000000000000000000000001111111111111111111111111111111111111111100000000000000000000000000001
100000000000000000000000000000000000000000000000000000000000000000000000000000000000000000000000000000000000000000000000000000000000000000000000000000000000000000000000000000000000000001
100000000000000000000000000000000000000000000000000000000000000000000000000000000000000000000000000000000000000000000000000000000000000000000000000000000000000000000000000000000000000001
100000000000000000000000000000000000000000000000000000000000000000000000000000000000000000000000000000000000000000000000000000000000000000000000000000000000000000000000000000000000000001
100000000000000000000000000000000000000000000000000000000000000000000000000000000000000000000000000000000000000000000000000000000000000000000000000000000000000000000000000000000000000001
100000000000000000000000000000000000000000000000000000000000000000000000000000000000000000000000000000000000000000000000000000000000000000000000000000000000000000000000000000000000000001
100000000000000000000000000000000000000000000000000000000000000000000000000000000000000000000000000000000000000000000000000000000000000000000000000000000000000000000000000000000000000001
100000000000000000000000000000000000000000000000000000000000000000000000000000000000000000000000000000000000000000000000000000000000000000000000000000000000000000000000000000000000000001
100000000000000000000000000000000000000000000000000000000000000000000000000000000000000000000000000000000000000000000000000000000000000000000000000000000000000000000000000000000000000001
100000000000000000000000000000000000011111111111111111111111111111111111111000000000000000000000000000000000000000000000000000000000000000000000011111100000000000000000000000000000000001
10000000000000000000000000000000000001                                    1000000000000000000000000000000000000000000000000000000000000000000000011111100000000000000000000000000000000001
10000000000000000000000000000000000001                                    1000000000000000000000000000000000000000000000000000000000000000000000011111100000000000000000000000000000000001
10000000000000000000000000000000000001                                    1000000000000000000000000000000000000000000000000000000000000000000000011111100000000000000000000000000000000001
10000000000000000000000000000000000001                                    1000000000000000000000000000000000000000000000000000000000000000000000011111100000000000000000000000000000000001
10000000000000000000000000000000000001                                    1000000000000000000000000000000000000000000000000000000000000000000000011111100000000000000000000000000000000001
10000000000000000000000000000000000001                                    1000000000000000000000000000000000000000000000000000000000000000000000011111100000000000000000000000000000000001
10000000000000000000000000000000000001                                    1000000000000000000000000000000000000000000000000000000000000000000000011111100000000000000000000000000000000001
10000000000000000000000000000000000001                                    1000000000000000000000000000000000000000000000000000000000000000000000011111100000000000000000000000000000000001
100000000000000000000000000000000000011111111111111111111111111111111111111000000000000000000000000000000000000000000000000000000000000000000000011111100000000000000000000000000000000001
100000000000000000000000000000000000000000000000000000000000000000000000000000000000000000000000000000000000000000000000000000000000000000000000011111100000000000000000000000000000000001
100000000000000000000000000000000000000000000000000000000000000000000000000000000000000000000000000000000000000000000000000000000000000000000000000000000000000000000000000000000000000001
100000000000000000000000000000000000000000000000000000000000000000000000000000000000000000000000000000000000000000000000000000000000000000000000000000000000000000000000000000000000000001
100000000000000000000000000000000000000000000000000000000000000000000000000000000000000000000000000000000000000000000000000000000000000000000000000000000000000000000000000000000000000001
100000000000000000000000000000000000000000000000000000000000000000000000000000000000000000000000000000000000000000000000000000000000000000000000000000000000000000000000000000000000000001
100000000000000000000000000000000000000000000000000000001100000000000000000000000000000000000000000000000000000000000000000000000000000000000000000000000000000000000000000000000000000001
100000000000000000000000000000000000000000000000000000001100000000000000000000000000000000000000000000000000000000000000000000000000000000000000000000000000000000000000000000000000000001
100000000000000000000000000000000000000000000000000000001100000000000000000000000000000000000000000000000000000000000000000000000000000000000000000000000000000000000000000000000000000001
100000000000000000000000000000000000000000000000000000001100000000000000000000000000000000000000000000000000000000000000000000000000000000000000000000000000000000000000000000000000000001
100000000000000000000000000000000000000000000000000000001100000000000000000000000000000000000000000000000000000000000000000000000000000000000000000000000000000000000000000000000000000001
100000000000000000000000000000000000000000000000000000001100000000000000000000000000000000000000000000000000000000000000000000000000000000000000000000000000000000000000000000000000000001
100000000000000000000000000000000000000000000000000000001100000000000000000000000000000000000000000000000000000000000000000000000000000000000000000000000000000000000000000000000000000001
100000000000000000000000000000000000000000000000000000001100000000000000000000000000000000000000000000000000000000000000000000000000000000000000000000000000000000000000000000000000000001
100000000000000000000000000000000000000000000000000000001100000000000000000000000000000000000000000000000000000000001111111111111111111111111111111111111111100000000000000000000000000001
100000000000000000000000000000000000000000000000000000001100000000000000000000000000000000000000000000000000000000001                                       100000000000000000000000000001
100000000000000000000000000000000000000000000000000000001100000000000000000000000000000000000000000000000000000000001                                       100000000000000000000000000001
100000000000000000000000000000000000000000000000000000001100000000000000000000000000000000000000000000000000000000001                                       100000000000000000000000000001
100000000000000000000000000000000000000000000000000000001100000000000000000000000000000000000000000000000000000000001                                       100000000000000000000000000001
100000000000000000000000000000000000000000000000000000001100000000000000000000000000000000000000000000000000000000001                                       100000000000000000000000000001
100000000000000000000000000000000000000000000000000000001100000000000000000000000000000000000000000000000000000000001                                       100000000000000000000000000001
100000000000000000000000000000000000000000000000000000000000000000000000000000000000000000000000000000000000000000001111111111111111111111111111111111111111100000000000000000000000000001
100000000000000000000000000000000000000000000000000000000000000000000000000000000000000000000000000000000000000000000000000000000000000000000000000000000000000000000000000000000000000001
100000000000000000000000000000000000000000000000000000000000000000000000000000000000000000000000000000000000000000000000000000000000000000000000000000000000000000000000000000000000000001
100000000000000000000000000000000000000000000000000000000000000000000000000000000000000000000000000000000000000000000000000000000000000000000000000000000000000000000000000000000000000001
100000000000000000000000000000000000000000000000000000000000000000000000000000000000000000000000000000000000000000000000000000000000000000000000000000000000000000000000000000000000000001
100000000000000000000000000000000000000000000000000000000000000000000000000000000000000000000000000000000000000000000000000000000000000000000000000000000000000000000000000000000000000001
100000000000000000000000000000000000000000000000000000000000000000000000000000000000000000000000000000000000000000000000000000000000000000000000000000000000000000000000000000000000000001
100000000000000000000000000000000000000000000000000000000000000000000000000000000000000000000000000000000000000000000000000000000000000000000000000000000000000000000000000000000000000001
100000000000000000000000000000000000000000000000000000000000000000000000000000000000000000000000000000000000000000000000000000000000000000000000000000000000000000000000000000000000000001
100000000000000000000000000000000000011111111111111111111111111111111111111000000000000000000000000000000000000000000000000000000000000000000000011111100000000000000000000000000000000001
10000000000000000000000000000000000001                                    1000000000000000000000000000000000000000000000000000000000000000000000011111100000000000000000000000000000000001
10000000000000000000000000000000000001                                    1000000000000000000000000000000000000000000000000000000000000000000000011111100000000000000000000000000000000001
10000000000000000000000000000000000001                                    1000000000000000000000000000000000000000000000000000000000000000000000011111100000000000000000000000000000000001
10000000000000000000000000000000000001                                    1000000000000000000000000000000000000000000000000000000000000000000000011111100000000000000000000000000000000001
10000000000000000000000000000000000001                                    1000000000000000000000000000000000000000000000000000000000000000000000011111100000000000000000000000000000000001
10000000000000000000000000000000000001                                    1000000000000000000000000000000000000000000000000000000000000000000000011111100000000000000000000000000000000001
10000000000000000000000000000000000001                                    1000000000000000000000000000000000000000000000000000000000000000000000011111100000000000000000000000000000000001
10000000000000000000000000000000000001                                    1000000000000000000000000000000000000000000000000000000000000000000000011111100000000000000000000000000000000001
100000000000000000000000000000000000011111111111111111111111111111111111111000000000000000000000000000000000000000000000000000000000000000000000011111100000000000000000000000000000000001
100000000000000000000000000000000000000000000000000000000000000000000000000000000000000000000000000000000000000000000000000000000000000000000000011111100000000000000000000000000000000001
100000000000000000000000000000000000000000000000000000000000000000000000000000000000000000000000000000000000000000000000000000000000000000000000000000000000000000000000000000000000000001
100000000000000000000000000000000000000000000000000000000000000000000000000000000000000000000000000000000000000000000000000000000000000000000000000000000000000000000000000000000000000001
100000000000000000000000000000000000000000000000000000000000000000000000000000000000000000000000000000000000000000000000000000000000000000000000000000000000000000000000000000000000000001
100000000000000000000000000000000000000000000000000000000000000000000000000000000000000000000000000000000000000000000000000000000000000000000000000000000000000000000000000000000000000001
100000000000000000000000000000000000000000000000000000001100000000000000000000000000000000000000000000000000000000000000000000000000000000000000000000000000000000000000000000000000000001
100000000000000000000000000000000000000000000000000000001100000000000000000000000000000000000000000000000000000000000000000000000000000000000000000000000000000000000000000000000000000001
100000000000000000000000000000000000000000000000000000001100000000000000000000000000000000000000000000000000000000000000000000000000000000000000000000000000000000000000000000000000000001
100000000000000000000000000000000000000000000000000000001100000000000000000000000000000000000000000000000000000000000000000000000000000000000000000000000000000000000000000000000000000001
100000000000000000000000000000000000000000000000000000001100000000000000000000000000000000000000000000000000000000000000000000000000000000000000000000000000000000000000000000000000000001
100000000000000000000000000000000000000000000000000000001100000000000000000000000000000000000000000000000000000000000000000000000000000000000000000000000000000000000000000000000000000001
100000000000000000000000000000000000000000000000000000001100000000000000000000000000000000000000000000000000000000000000000000000000000000000000000000000000000000000000000000000000000001
100000000000000000000000000000000000000000000000000000001100000000000000000000000000000000000000000000000000000000000000000000000000000000000000000000000000000000000000000000000000000001
100000000000000000000000000000000000000000000000000000001100000000000000000000000000000000000000000000000000000000001111111111111111111111111111111111111111100000000000000000000000000001
100000000000000000000000000000000000000000000000000000001100000000000000000000000000000000000000000000000000000000001                                       100000000000000000000000000001
100000000000000000000000000000000000000000000000000000001100000000000000000000000000000000000000000000000000000000001                                       100000000000000000000000000001
100000000000000000000000000000000000000000000000000000001100000000000000000000000000000000000000000000000000000000001                                       100000000000000000000000000001
100000000000000000000000000000000000000000000000000000001100000000000000000000000000000000000000000000000000000000001                                       100000000000000000000000000001
100000000000000000000000000000000000000000000000000000001100000000000000000000000000000000000000000000000000000000001                                       100000000000000000000000000001
100000000000000000000000000000000000000000000000000000001100000000000000000000000000000000000000000000000000000000001                                       100000000000000000000000000001
100000000000000000000000000000000000000000000000000000000000000000000000000000000000000000000000000000000000000000001111111111111111111111111111111111111111100000000000000000000000000001
100000000000000000000000000000000000000000000000000000000000000000000000000000000000000000000000000000000000000000000000000000000000000000000000000000000000000000000000000000000000000001
100000000000000000000000000000000000000000000000000000000000000000000000000000000000000000000000000000000000000000000000000000000000000000000000000000000000000000000000000000000000000001
100000000000000000000000000000000000000000000000000000000000000000000000000000000000000000000000000000000000000000000000000000000000000000000000000000000000000000000000000000000000000001
10000000000000000000000000000000000000000000000000000000000000000000000000000000000000000000000N000000000000000000000000000000000000000000000000000000000000000000000000000000000000000001
100000000000000000000000000000000000000000000000000000000000000000000000000000000000000000000000000000000000000000000000000000000000000000000000000000000000000000000000000000000000000001
100000000000000000000000000000000000000000000000000000000000000000000000000000000000000000000000000000000000000000000000000000000000000000000000000000000000000000000000000000000000000001
100000000000000000000000000000000000000000000000000000000000000000000000000000000000000000000000000000000000000000000000000000000000000000000000000000000000000000000000000000000000000001
100000000000000000000000000000000000000000000000000000000000000000000000000000000000000000000000000000000000000000000000000000000000000000000000000000000000000000000000000000000000000001
100000000000000000000000000000000000011111111111111111111111111111111111111000000000000000000000000000000000000000000000000000000000000000000000011111100000000000000000000000000000000001
10000000000000000000000000000000000001                                    1000000000000000000000000000000000000000000000000000000000000000000000011111100000000000000000000000000000000001
10000000000000000000000000000000000001                                    1000000000000000000000000000000000000000000000000000000000000000000000011111100000000000000000000000000000000001
10000000000000000000000000000000000001                                    1000000000000000000000000000000000000000000000000000000000000000000000011111100000000000000000000000000000000001
10000000000000000000000000000000000001                                    1000000000000000000000000000000000000000000000000000000000000000000000011111100000000000000000000000000000000001
10000000000000000000000000000000000001                                    1000000000000000000000000000000000000000000000000000000000000000000000011111100000000000000000000000000000000001
10000000000000000000000000000000000001                                    1000000000000000000000000000000000000000000000000000000000000000000000011111100000000000000000000000000000000001
10000000000000000000000000000000000001                                    1000000000000000000000000000000000000000000000000000000000000000000000011111100000000000000000000000000000000001
10000000000000000000000000000000000001                                    1000000000000000000000000000000000000000000000000000000000000000000000011111100000000000000000000000000000000001
100000000000000000000000000000000000011111111111111111111111111111111111111000000000000000000000000000000000000000000000000000000000000000000000011111100000000000000000000000000000000001
100000000000000000000000000000000000000000000000000000000000000000000000000000000000000000000000000000000000000000000000000000000000000000000000011111100000000000000000000000000000000001
100000000000000000000000000000000000000000000000000000000000000000000000000000000000000000000000000000000000000000000000000000000000000000000000000000000000000000000000000000000000000001
100000000000000000000000000000000000000000000000000000000000000000000000000000000000000000000000000000000000000000000000000000000000000000000000000000000000000000000000000000000000000001
100000000000000000000000000000000000000000000000000000000000000000000000000000000000000000000000000000000000000000000000000000000000000000000000000000000000000000000000000000000000000001
100000000000000000000000000000000000000000000000000000000000000000000000000000000000000000000000000000000000000000000000000000000000000000000000000000000000000000000000000000000000000001
100000000000000000000000000000000000000000000000000000001100000000000000000000000000000000000000000000000000000000000000000000000000000000000000000000000000000000000000000000000000000001
100000000000000000000000000000000000000000000000000000001100000000000000000000000000000000000000000000000000000000000000000000000000000000000000000000000000000000000000000000000000000001
100000000000000000000000000000000000000000000000000000001100000000000000000000000000000000000000000000000000000000000000000000000000000000000000000000000000000000000000000000000000000001
100000000000000000000000000000000000000000000000000000001100000000000000000000000000000000000000000000000000000000000000000000000000000000000000000000000000000000000000000000000000000001
100000000000000000000000000000000000000000000000000000001100000000000000000000000000000000000000000000000000000000000000000000000000000000000000000000000000000000000000000000000000000001
100000000000000000000000000000000000000000000000000000001100000000000000000000000000000000000000000000000000000000000000000000000000000000000000000000000000000000000000000000000000000001
100000000000000000000000000000000000000000000000000000001100000000000000000000000000000000000000000000000000000000000000000000000000000000000000000000000000000000000000000000000000000001
100000000000000000000000000000000000000000000000000000001100000000000000000000000000000000000000000000000000000000000000000000000000000000000000000000000000000000000000000000000000000001
100000000000000000000000000000000000000000000000000000001100000000000000000000000000000000000000000000000000000000001111111111111111111111111111111111111111100000000000000000000000000001
100000000000000000000000000000000000000000000000000000001100000000000000000000000000000000000000000000000000000000001                                       100000000000000000000000000001
100000000000000000000000000000000000000000000000000000001100000000000000000000000000000000000000000000000000000000001                                       100000000000000000000000000001
100000000000000000000000000000000000000000000000000000001100000000000000000000000000000000000000000000000000000000001                                       100000000000000000000000000001
100000000000000000000000000000000000000000000000000000001100000000000000000000000000000000000000000000000000000000001                                       100000000000000000000000000001
100000000000000000000000000000000000000000000000000000001100000000000000000000000000000000000000000000000000000000001                                       100000000000000000000000000001
100000000000000000000000000000000000000000000000000000001100000000000000000000000000000000000000000000000000000000001                                       100000000000000000000000000001
100000000000000000000000000000000000000000000000000000000000000000000000000000000000000000000000000000000000000000001111111111111111111111111111111111111111100000000000000000000000000001
100000000000000000000000000000000000000000000000000000000000000000000000000000000000000000000000000000000000000000000000000000000000000000000000000000000000000000000000000000000000000001
100000000000000000000000000000000000000000000000000000000000000000000000000000000000000000000000000000000000000000000000000000000000000000000000000000000000000000000000000000000000000001
100000000000000000000000000000000000000000000000000000000000000000000000000000000000000000000000000000000000000000000000000000000000000000000000000000000000000000000000000000000000000001
100000000000000000000000000000000000000000000000000000000000000000000000000000000000000000000000000000000000000000000000000000000000000000000000000000000000000000000000000000000000000001
111111111111111111111111111111111111111111111111111111111111111111111111111111111111111111111111111111111111111111111111111111111111111111111111111111111111111111111111111111111111111111