F   192, 192 , 192

SO     ./textures/blue.xpm
WE      ./textures/red.xpm


C   135, 206 ,250

NO       ./textures/yellow.xpm
EA     ./textures/pink.xpm






                          111
                         10001
                        1000001
                       100000001
                      10000100001
                     100001 100001
                    100001   100001  
                   100001     100001
                  100001       100001
                 100001         100001
                100001     1     100001
               100001     101     100001
              100001111111000111111100001
             10000000000000N00000000000001
              100001111111000111111100001         
               100001     101     100001            
                100001     1     100001                 
                 100001         100001                     
                  100001       100001               
                   100001     100001             
                    100001   100001        
                     100001 100001
                      10000100001
                       100000001         
                        1000001
                         10001
                          111    