F   192, 192 , 192

SO     ./textures/blue.xpm
WE      ./textures/red.xpm


C   135, 206 ,250

NO      ./textures/pink.xpm
EA     ./textures/yellow.xpm



111111111111111111111                       111111111111111111111
100000000000000000001                       100000000000000000001
100000000000000000001                       100000000000000000001
10000000000000000000111111111111111111111111100000000000000000001
10000000000000000000000000000000000000000000000000000000000000001
10000000000000000001111111111111011111111111100000000000000000001
10000000000000000001           101          100000000000000000001
10000000000000000001           101          100000000000000000001
11111111111111111111           101          111111111111111111111
                               101
                               101
                               101
                               101
                               101
                               101
                    11111111111101111111111
                    10000000000000000000001
                    10000000000000000000001
                    10000000000000000000001
                    10000000000000000000001
                    100000000000N0000000001
                    10000000000000000000001
                    10000000000000000000001
                    10000000000000000000001
                    11111111111101111111111
                               101
                               101
                               101
                               101
                               101
                               101
111111111111111111111          101          111111111111111111111
100000000000000000001          101          100000000000000000001
100000000000000000001          101          100000000000000000001
10000000000000000000111111111111011111111111100000000000000000001
10000000000000000000000000000000000000000000000000000000000000001
10000000000000000001111111111111111111111111100000000000000000001
10000000000000000001                        100000000000000000001
10000000000000000001                        100000000000000000001
11111111111111111111                        111111111111111111111