F   192, 192 , 192

SO     ./textures/blue.xpm
WE      ./textures/red.xpm


C   135, 206 ,250

NO       ./textures/yellow.xpm
EA     ./textures/pink.xpm


                   1111111111111111111
                  100000000000000000001
                 10000000000000000000001
                1000000000000000000000001
               100001111111111111111110001
              100001 1000000000000001 10001
             100001  1000000000000001  10001
            100001   1000000000000001   10001
           100001    1000000000000001    10001
          100001     1000000000000001     10001
         100001      1000000000000001      10001
        100001       1000000000000001       10001
       1000011111111111111110001111111111111000001
      10000000000000000000000N000000000000000000001
       1000011111111111111110001111111111111100001
        100001       1000000000000001       10001
         100001      1000000000000001      10001
          100001     1000000000000001     10001
           100001    1000000000000001    10001
            100001   1000000000000001   10001
             100001  1000000000000001  10001
              100001 1000000000000001 10001
               100001111111111111111110001
                1000000000000000000000001
                 10000000000000000000001
                  100000000000000000001
                   1111111100011111111
                          10001
111111111111111111111111111000111111111111111111111111111111111111111111111111111111
100000000000000000000000000000000000000000000000000000000000000000000000000000000001
100000000000000000000000000000000000000000000000000000000000000000000000000000000001
100000000000000000001111111111111111111111111111111111100011111111111111111110010001
10000000000000000001          100000000000000000000000000000000000000000000010001111
10000000000000000001          100000000000000000000000000000000000000000000010001
11111111111111111111          111111111111000111111111111111111111111111111110001
                               10000000000000000000000000000000000000000000000001
                               10000000000000000000000000000000000000000000000001
                               10000000000000000000000000000000000000000000000001
                               10000000000000000000000000000000000000000000000001
                               10000000000000000000000000000000000000000000000001
                               10000000000000000000000000000000000000000000000001
                               10000000000000000000000000000000000000000000000001
                               10000000000000000000000000000000000000000000000001
                               10000000000000000000000000000000000000000000000001
11111111111111111111111111111111111111000111111111111111111111110001111111111111111
100000000000000000000000000000000000000000000000000000000000000000000000000000000001
100000000000000000000000000000000000000000000000000000000000000000000000000000000001
1000000000000000000011111111111111111111111000111111111111111111111111111111100010001
10000000000000000001          100000000000000000000000000000000000000000000010001111
10000000000000000001          100000000000000000000000000000000000000000000010001
11111111111111111111          111111111111111111111100011111111111111111111110001
                               10000000000000000000000000000000000000000000000001
                               10000000000000000000000000000000000000000000000001
                               10000000000000000000000000000000000000000000000001
                               10000000000000000000000000000000000000000000000001
                               10000000000000000000000000000000000000000000000001
                               11111111111111111111111111111111111111111111111111