F   192, 192 , 192

SO     ./textures/blue.xpm
WE      ./textures/red.xpm


C   135, 206 ,250

NO      ./textures/pink.xpm
EA     ./textures/yellow.xpm

11111
10001
10001
10N01
11111